####..####
####..####
####..####
####..####
###....###
###..B.###
###BBTB###
##########
##########
##########
