##########
##########
####<.####
##...E..##
##..%%..##
##..%%..##
##..%%..##
##......##
####..####
####..####
