####..####
#........#
#.E%..%E.#
#E.%E.%.E#
#..%..%K.#
#.E%.E%.E#
#E.%..%E.#
#..%..%..#
#........#
####..####
