####..####
####..####
####..####
####..####
###....###
###..B.###
###.BT.###
##########
##########
##########
