##########
##########
####..####
##......##
##......##
##..Q...##
##......##
##......##
####..####
####DD####
