####..####
#........#
#..%..%..#
#..%..%..#
..E%E.%E.#
...%..%..#
#..%..%..#
#..%..%..#
#........#
####..####
