####..####
#........#
#..%..%..#
#..%..%E.#
...%EE%.E#
...%..%E.#
#B.%....##
#..%..B###
#.....####
##########
