####DD####
#.<......#
#........#
#........#
#.........
#.........
#........#
#........#
#........#
####..####
