####DD####
#.>......#
#........#
#........#
#.........
#.........
#........#
#........#
#........#
####..####
