##########
####.....#
###B..%..#
##....%..#
#..%..%...
#..%.E%...
#..%E.%..#
#..%..%..#
#.......B#
####..####
