####..####
#........#
#B.%..%..#
#..%..%.E#
#B.%..%...
#..%EE%...
##..EE%..#
###...%..#
####.....#
##########
