##########
##########
##......##
##...Q..##
##..%%..##
##..%%..##
##..%%..##
##......##
##......##
####DD####
