##########
#........#
#...%%...#
#...%%...#
#...%%...#
#........#
#.######.#
..#.>..#.#
#.#....#.#
#####.####
