#...#....#
#>.##....#
#..#.....#
####.....#
.#########
..#......#
..#......#
..###.####
.........#
##########
