####..####
#........#
#....%...#
#...%....#
#....%...#
#.E.%..E.#
#....%...#
#...%.....
#....%...#
#.######.#
