####..####
##.......#
#>......##
##.......#
###......#
####.....#
#####.####
#...#....#
#.T.#.####
#...#....#
