#####.####
#...#.#..#
#.#...#.##
#.#####..#
#...#.##..
###.#.....
#...##.#..
#......##.
#......##.
##########
