#.######.#
#....%...#
#...%....#
#....%...#
#...%....#
###..%...#
#>#.%....#
#D#..%..##
#>##>#>###
##########
