##########
#........#
#...%%E..#
#...%%.E.#
#...%%...#
#........#
#.######.#
..#.>..#T#
#.#....#B#
#####.####
