##########
#.......K#
#>.......#
####.....#
...#.....#
..###....#
######...#
####.##..#
####..#..#
####..####
