#####.####
#...#.#.E#
#.#...#.##
#.#####..#
#...#E##..
###.#.....
#...##.#..
#......##.
#......##.
##########
