##########
#.......K#
#>....E..#
####...E.#
...#....E#
..###....#
######...#
####B##..#
####..#..#
####..####
