####..####
##.......#
#>..E...##
##....E..#
###......#
####.....#
#####.####
#.E.#....#
#.T.#.####
#...#....#
