##########
##.#..#.##
#...<....#
##......##
#..%..%...
#.........
##......##
#........#
##.#..#.##
####..####
