#.######.#
#....%...#
#...%....#
#.E..%...#
#...%..E.#
###..%...#
#>#.%....#
#D#..%..##
#>##>#>###
##########
