##########
#.......T#
#......E.#
#%%%%.%%%#
..........
..........
#%%%%.%%%#
#......E.#
#.......>#
##########
