#...#....#
#>.##....#
#..#..E..#
####.....#
.#########
..#.B..E.#
..#......#
..###.####
.........#
##########
