##########
#.......T#
#......E.#
#%%%%.%%%#
..........
..........
#%%%%.%%%#
#......E.#
#......>.#
##########
