#...#.#.#.
.%..#.#.#.
..%.#.#.#.
..>.#.#.#.
#####.#.#.
......#.#.
#######.#.
........#.
#########.
..........
