..........
.#########
.#<.......
.#.#######
.#.#......
.#.#.#####
.#.#.#.>..
.#.#.#.%..
.#.#.#..%.
.#.#.#....
