.#.#.#....
.#.#.#..%.
.#.#.#.%..
.#.#.#.>..
.#.#.#####
.#.#......
.#.#######
.#........
.###..####
...%%%%...
