..........
.#########
.#<....E..
.#.#######
.#.#......
.#.#.#####
.#.#.#.>..
.#.#.#.%.E
.#.#.#.E%.
.#.#.#...#
