##########
####....>#
#.......##
#....#..##
#.####..##
#.#..#####
#....##...
###.....%%
###>.##%T<
##########
