##########
#..#..#E##
#<.#TBTB.#
##.#....##
#..#BBBB##
#B.#.....#
####E.E.##
#>E#....E#
#EE#..#.##
##.#..####
