#.########
#....%..>#
#.....%.##
#....%...#
#...%....#
###..%...#
#>#...%..#
####.%..##
#<>#<#<###
##########
