..........
#########.
........#.
#######.#.
....<.#.#.
#####.#.#.
....#.#.#.
..%.#.#.#.
.%..#.#>#.
....#.#.#.
