##########
####....>#
#.E.....##
#....#E.##
#.####..##
#.#..#####
#....##...
###E....%%
###>.##%T<
##########
