##.#DD####
#........#
#.%....%.#
#..%..%..#
#........#
#........#
#..%..%..#
#.%....%.#
#........#
#.########
