##########
#<......>#
#..%%....#
#.%<K%...#
#######..#
##....#..#
......#.>#
......#..#
%#....#..#
##########
