#.E.#.#.#.
.%..#.#E#.
.E%.#.#.#.
..>.#.#.#.
#####.#.#.
......#.#.
#######.#.
........#.
#########.
..........
