##########
#..#..#.##
#<.#.....#
##.#....##
#..#....##
#..#.....#
####....##
#.>#.....#
#..#..#.##
##.#..####
