##.#DD####
#........#
#.%....%.#
#..%..%E.#
#...E....#
#........#
#..%..%E.#
#.%....%.#
#........#
#.########
