##########
#<......>#
#..%%....#
#.%<K%...#
#######..#
##....#..#
....E.#.>#
%.....#..#
%#....#.E#
##########
