#.########
#...E%..>#
#.E...%.##
#....%...#
#...%....#
###..%...#
#>#...%..#
####.%..##
#<>#<#<###
##########
