#.#.#DD#.#
#......E.#
#.%%..%%.#
#...E....#
#...%%...#
#........#
#..%..%..#
#.%....%.#
#........#
#.#.##.###
