##########
##><..#.>#
.#....#..#
.#.<..#..#
>#....#..#
.#########
##.......#
.#><.....#
.#.......#
##########
