#.#.#DD#.#
#........#
#.%%..%%.#
#........#
#...%%...#
#........#
#..%..%..#
#.%....%.#
#........#
#.#.##.###
