####..####
#..#.....#
#..###....
#....#....
#....#....
#....#....
#....#####
#.........
#........<
##########
