##########
###....###
#........#
###....###
#........#
#...<....#
#........#
#........#
#........#
##########
