##########
##><.E#..#
B#....#.>#
.#.<..#..#
>#..B.#..#
.#########
##.......#
.#><.....#
.#B.....E#
##########
