##########
#..#EE#EE#
#<.#EE#EE#
##.#.###.#
#..#.#T#.#
#B.#.#.#.#
####.#E#.#
#>#..#.#.#
#.#B##.#.#
#.#.#.>#.#
