##########
#>.......#
##......##
###....###
###....###
###....###
###....###
##......##
#........#
##########
