##########
####E.####
###EE..###
##......##
#.......E#
##......##
###....###
##..##..##
#>E####.E#
####.E####
