#.#.##.###
#...#..#<#
#...#..#.#
########.#
##E.K.E#.#
###E.E##.#
#>##.###.#
####.###.#
#><#.....#
##########
