#.#.##.###
#EEE#EE#<#
#EEE#EE#.#
########.#
##E.K.E#.#
###E.E##.#
#>##.###.#
####.###.#
#><#.....#
##########
