##########
####..####
###....###
##......##
#........#
##......##
###....###
##..##..##
#>.####..#
####..####
