##########
#.>#.#.#.#
#.##.....#
#.#....###
#.#.##...#
#.###...##
#.##..#.##
#.#..##..#
#...##..##
##########
