##########
#>.......#
##......##
###.EE.###
###E..E###
###.EE.###
###....###
##......##
#........#
##########
