##########
#..#..#..#
#<.#..#..#
##.#.###.#
#..#.#T#.#
#..#.#.#.#
####.#.#.#
#>#..#.#.#
#.#.##.#.#
#.#.#.>#.#
