#.#.#%.#.#
#.#.#..#.#
#.#.#.%#.#
#.#.#..#.#
#.#.#%.#.#
#.#.#..#.#
#.#.#.%#.#
#.#.#..#.#
#.#.#%<#.#
#.#.#.%#.#

