##########
#........#
.........#
#%%%.%%%%#
..........
#.........
..%%.%%%%#
#........#
.........#
##########
