#.#....#.#
#.....##..
#.....#...
#.....#...
#.....#...
#.....##..
#......###
#.........
#........#
##########
