####..####
##<#..#>##
#....%...#
##..%E%.##
...%EEE%.#
....%.%..#
##......##
#........#
##B#..#B##
##########
