#.#.#%.#.#
#.#.#.%#.#
#.#.#%.#..
#E#E#%%###
#...#.....
###.######
#>#.E.....
####.#####
#<D.......
##########
