####..####
##<#..#>##
#....%...#
##..%.%.##
...%...%.#
....%.%..#
##......##
#........#
##.#..#.##
##########
