##########
......#...
#####.#.##
....#.#...
#####.####
......#...
##########
#........#
#.######.#
#.#....#.#
