##########
#..E..B..#
..E.....B#
#%%%.%%%%#
..........
#.........
..%%.%%%%#
#BE......#
.E.B.....#
##########
