##########
........B#
##########
.....E...#
########.#
.E.......#
####..####
#.E.EE.E.#
#E..EE..E#
####..####
