##########
#..E....E.
#<########
#.#...E...
#.#E######
#.#.#EEEEE
#.#.#E####
#E#.#EEEE#
#.#.####E#
#.#.#EK#E#
