####..####
.........#
.........#
.........#
.........#
.........#
#........#
.........#
#........#
####..####
