#.#.#%.#.#
#.#.#.%#.#
#.#.#%.#..
#.#.#%%###
#...#.....
###.######
#>#.......
####.#####
#<D.......
##########
