####..####
.........#
.........#
...%..%..#
....EE...#
....EE...#
#..%..%..#
.........#
#........#
####..####
