##########
......#..E
#####.#.##
..EB#.#...
#####.####
......#B..
##########
#E..B..E.#
#.######.#
#.#EEEE#.#
