##########
#.........
#<########
#.#.......
#.#.######
#.#.#.....
#.#.#.####
#.#.#....#
#.#.####.#
#.#.#.K#.#
