##########
.........#
##########
.........#
########.#
.........#
####..####
#........#
#........#
####..####
