####..####
#..%..%..#
#........#
#..%..%..#
#........#
#%.%..%..#
.........#
#%.%..%..#
#........#
##########
