#.########
.........#
.........#
.........#
.........#
.........#
.........#
.........#
.........#
##########
