##########
..........
..........
..........
....Q.....
..........
..........
..........
..........
#........#
