##########
#........#
#........#
#........#
#........#
#.%.%.%.%#
#.........
#.%.%.%.%#
#........#
##########
