##########
#........#
#........#
#........#
#...%%...#
#...%%...#
#........#
#......>.#
#........#
##########
