##########
#E..EE..E#
#........#
#........#
#Q..%%...#
#...%%...#
#........#
#......<.#
#E..EE..E#
##########
