#........#
#.........
#.........
#.........
#...Q.....
#.........
#.........
#.........
#.........
##########
