##########
#.........
#.........
#.........
#...Q.....
#.........
#.........
#.........
#.........
#........#
