#........#
..........
..........
..........
....Q.....
..........
..........
..........
..........
####DD####
