##########
#E.##.####
#..##.####
#..##.##.#
#.........
#..##.####
#..##.####
#..##.####
#B.##.####
#####.####
