####.#####
#........#
#..#..#..#
#..#..#..#
#..#E.#..#
#..#..#..#
#..#..#..#
#..#..#..#
#........#
####.#####
