#####.####
#..##.##.#
#B.##.##E#
#........#
#........#
#........#
#........#
#........#
#........#
#####.####
