##########
###...####
###.K.####
####.##E##
........##
####..####
####..#E##
###..##.##
###.....##
##########
