####.#####
#........#
#..%..%..#
#..%..%..#
#..%E.%..#
#..%..%..#
#..%..%..#
#..%..%..#
#........#
####.#####
