#####D####
#........#
#........#
#........#
..........
#........#
#........#
#........#
#....@...#
##########
