##########
#........#
#........#
#.%...%..#
#.E...E..#
#...%....#
#...B....#
#........#
#........#
####.#####
