##########
###.>T.###
##......##
#.E....E.#
#B...E...#
#........#
#........#
##......##
###....###
#####.####
