#####.####
#........#
#........#
#........#
#....E....
#........#
#........#
#........#
#........#
##########
