####.#####
#........#
#........#
#........#
....E....#
#........#
#........#
#.....B..#
#........#
##########
