####.#####
#.......##
#........#
#........#
#........#
#.........
#........#
#........#
##.......#
##########
