##########
####<.####
####..####
####..####
#........#
#..B..B..#
####..####
####..####
####..####
####..####
