##########
#.......##
#........#
#........#
#....K...#
.........#
#........#
#........#
##.......#
##########
