##########
#..##E#.B#
##..#.#.##
#..##.#.##
#.......##
..........
#..##....#
#.##..##.#
#.#T.##..#
##########
