##########
#####.####
####...###
###..#..##
##E.###..#
#..#####..
##..###..#
###..#.E##
####...###
#####.####
