##########
##......##
#......<.#
#........#
#........#
#........#
#...EE...#
#........#
##......##
#####.####
