##########
##......##
#........#
#........#
#........#
#........#
#........#
#........#
##......##
#####.####
