##########
##......##
#......>.#
#........#
#........#
#........#
#...EE...#
#........#
##......##
#####.####
