####..####
#........#
#........#
#........#
#........#
..........
#........#
#........#
#........#
##########
