##########
#.E...E.##
#........#
#........#
#....K...#
.........#
#....E...#
#.......E#
##.......#
##########
