##########
#..##.#..#
##..#.#.##
#..##.#.##
#.......##
..........
#..##....#
#.##..##.#
#.#..##..#
##########
