#####D####
#####.####
####..####
####..####
###....###
.......###
###....###
##########
##########
##########
