####..####
#........#
#........#
#........#
#........#
.....E....
#........#
#........#
#........#
##########
