####.#####
#.......##
#E.......#
#........#
#........#
#..E......
#........#
#........#
##.......#
##########
