####..####
###......#
##....%..#
#....%..%#
....%E.%.#
...%..%..#
#.%.E%...#
#%..%.ET.#
#........#
##########
