####DD####
###...####
##...##..#
##...##E.#
#E........
##...E....
##.#.....#
##.#.#...#
#######.##
##########
