##########
###.##.###
##......##
#...BT...#
..........
..%....%..
#.%.##.%.#
#.%.##.%.#
#...##...#
##########
