##########
#.......%#
#...%..%.#
#..%..%..#
..%.E.....
.......%..
#..%..%..#
#.%..%...#
#%.......#
##########
