##########
###.%....#
##...%.K.#
#.<.%....#
.....%....
..E.%.....
#....%...#
##..%....#
###..%...#
##########
