##########
#B#BB.#EE#
#.###.##E#
#..##.##.#
#.E.......
##..#.##..
###.#.#..#
#B###.#.##
#.....####
##########
