##########
###B##.E##
###..#.###
##...#.#.#
##.###.#..
##.##..#..
##..##.#.#
#...##.#.#
#........#
####..####
