##########
###.%....#
##>..%.K.#
#...%....#
.....%....
..E.%.....
#....%...#
##..%....#
###..%...#
##########
