####..####
##......##
#......<.#
#........#
...E.....#
.........#
#..B.....#
#T.......#
##......##
####..####
