##########
#........#
#.%%..%%.#
#.%%..%%.#
....E....#
.....E...#
#.%%..%%.#
#.%%..%%.#
#........#
####..####
