####..####
#........#
#..%.....#
#........#
....E.....
..........
#.....%..#
#........#
#........#
##########
