####..####
#..%..%..#
#...%%...#
#%.....>.#
..%.E....#
..%......#
#%.......#
#........#
#........#
####..####
