####..####
#.....%..#
#..%.E...#
#........#
#....%....
#.%.......
#......%.#
#...%....#
#T.......#
##########
