##########
#...T%...#
#.E......#
#........#
#.........
#.........
#........#
#......E.#
#........#
####..####
