####..####
#..%..%..#
#...%%.>.#
#%.......#
..%.E....#
..%......#
#%.......#
#........#
#........#
####..####
