##########
#........#
#.<....E.#
#........#
..........
..........
#.E.B....#
#..%%%%%.#
#..%%%%..#
####..####
