####..####
#........#
#.E......#
#.....%..#
#..%..%...
#..%..%.E.
#........#
#...E....#
#........#
####..####
