####..####
#........#
#......K.#
#....E...#
..%.%.%...
..........
#........#
#.E......#
#........#
####..####
