####..####
#..%..%..#
#...##...#
#%.....>.#
..%.E....#
..%......#
#%.......#
#........#
#........#
####..####
