####DD####
#..%.....#
#...%....#
#..%.....#
........%#
....E..%T#
#.....%..#
#......%.#
#........#
##########
