##########
#...%...B#
#..%.%...#
#...%....#
....E....#
.....E...#
#........#
#........#
#........#
####..####
