##########
###....###
##......##
#........#
....E.....
..........
#........#
##......##
###....###
##########
