##########
##########
###....###
#........#
#...K.....
#.........
#........#
###....###
##########
##########
