##########
#.T.#E#E##
##.##.#.E#
##......##
#E........
######.#..
#......#.#
#.######.#
#.....#B.#
####..####
