##########
###....###
##......##
#........#
D....Q...D
D........D
#........#
##......##
###....###
##########
