####DD####
#...E.#.##
#.#####..#
#.#......#
#.#.####..
#.#....#..
#.####.#.#
#.##...#.#
#....###E#
##########
