##########
#.#.##..B#
#.#..#.###
#.#..#..##
..##.#..##
...#....##
##.##.%E.#
#.....%%.#
#.#......#
####..####
