####..####
##.......#
#..##.#.##
#####.#..#
..#.#E##.#
..#.###..#
#.#E..#..#
#.#.####.#
#........#
##########
