##########
###...>..#
##.......#
#........#
....B....#
.........#
#.......##
#......###
#.....####
##########
