####..####
##.....#.#
#..##..#.#
#...####.#
...##.#...
....E.....
#..###...#
#...#....#
##..##.###
##########
