##########
#E.....###
##.....<##
###......#
#........#
#........#
#........#
##....#..#
###...##E#
####..####
