####..####
####.%####
####..####
####%.####
.........#
.........#
####..####
##...E..##
##......##
##########
