####..####
#........#
##.......#
###......#
..........
..........
#........#
#...#....#
#E..##...#
##########
