##########
###..K.###
###....###
#...EE...#
#...EE...#
#T.....%T#
#........#
###....###
###....###
####..####
