##########
###..K.###
###....###
#EE.EE.EE#
#B......B#
#T.....%T#
#........#
###....###
###....###
####..####
