##########
###..K.###
###....###
#...EE...#
#B..EE..B#
#T.....%T#
#........#
###....###
###....###
####..####
