##########
#...##<..#
#........#
#........#
.........#
.E.......#
#........#
#........#
#...##...#
##########
