##########
##..<...##
#........#
#...E....#
#........#
#........#
#........#
#.......##
##.....###
####..####
