####..####
###......#
##.......#
#........#
#...E....#
#........#
####.....#
#E.......#
###......#
####..####
