####..####
#B#..#####
#....#E#E#
##.#.#.#.#
#..#.#.#..
#..###.#..
##..##.#.#
#....#.#.#
##.......#
##########
