####DD####
###......#
##.......#
#........#
#...E....#
#........#
####.....#
#........#
###......#
####..####
