##########
#...##<..#
#........#
#........#
.E.......#
.E.......#
#........#
#...BB...#
#...##...#
##########
