##########
#...##>..#
#........#
#........#
.........#
.E.......#
#........#
#........#
#...##...#
##########
