##########
#........#
#.E ......#
#....%...#
#...%.....
#...%%....
#....E...#
##B......#
###......#
####..####
