####..####
####...###
#..#...T##
#........#
##......##
###......#
##E...####
##....####
##....####
####..####
