##########
#%.%%.E>.#
#%%%%%.E.#
#B%%%....#
..%%.%%.%#
..%%%%%..#
#%.%.%...#
#.%%%%..##
#%%......#
####..####
