####..####
####..####
#.......##
#.########
#.....#...
#.%%E.....
##E....###
#####.####
####ETE###
##########
