##########
#%.%%.E<.#
#%%%%%.E.#
#B%%%....#
..%%.%%.%#
..%%%%%..#
#%.%.%...#
#.%%%%..##
#%%......#
####..####
