##########
##.#>.#.##
##.#..#.##
##.#..#.##
#..#..#...
#T........
##.#..#.##
##.#..#.##
##.#..#.##
####..####
