##########
#.%%..%%.#
#.%%E.%%.#
#........#
..........
..%%.E%%..
#.%%..%%.#
#...%%...#
#E..%%..E#
##########
