##########
#........#
#B%%%%%%E#
#........#
..%%%%%%E.
..........
#.%%%%%%E#
#........#
#.%%%%%%B#
##########
