##########
#E##.E.E.#
#.E#..#.##
##.#.#####
...#......
..##.##...
#.....#.##
#..##.#E.#
#..#B.#..#
##########
