####..####
#........#
#.%.%.%..#
#%.%E%.%.#
.K%......#
.E%%..####
#%.......#
#.%%%%%%.#
#........#
####..####
