##########
#%.%%BE>.#
#%%%%%.E.#
#B%%%....#
..%%.%%.%#
.B%%%%%..#
#%.%.%...#
#.%%%%..##
#%%......#
####..####
