####..####
#........#
#..#####.#
####.....#
..##.#####
...#.....#
##.##E##.#
##..###..#
###E....##
##########
