##########
#E##.E.E.#
#.E#..#.##
##.#.#####
...#......
..##.##...
#.....#.##
#..##E#EE#
#..#BE#EE#
##########
