####..####
#........#
#E%.%.%E%#
#.%.%.%.%#
#.%.%.%...
#E%.%.%E..
#.%B%B%B%#
#E%.%.%E%#
#........#
####..####
