####..####
#........#
#.%.%.%E%#
#.%.%.%.%#
#.%.%.%...
#.%.%.%E..
#.%.%.%.%#
#.%.%.%E%#
#........#
####..####
