##########
#....E...#
#B%%%%%%E#
#....E...#
..%%%%%%E.
.....E....
#.%%%%%%E#
#....E...#
#.%%%%%%B#
##########
