####..####
#.....####
#.E.....##
####....##
####..E...
####......
##.E....##
##......##
#####E..##
##########
