####..####
#.....####
#..#######
#...######
#....#####
#..E..####
#......###
#E....E.##
#..E.....#
####..####
