####..####
#B......B#
#B......B#
####..####
..#E..E###
..##..####
#.......##
#........#
####..####
##########
