####..####
#........#
#.E......#
##......##
#........#
#.......E#
##..E...##
#........#
#........#
####..####
