####..####
#........#
#...%E.%.#
#..%..%..#
..%.E%.E.#
....%....#
#..%.....#
#....%%..#
#...%.%..#
##########
