####DD####
#........#
#.E......#
#........#
....%%E...
...EB%....
#.E......#
#........#
#........#
##########
