##########
##.....<##
##......##
#........#
#........#
####..####
####..####
##......##
#........#
####..####
