####..####
#........#
#........#
####..####
..#E..E###
..##..####
#.......##
#........#
####..####
##########
