##########
#.......>#
#........#
#.T......#
#........#
#...E....#
#........#
##......##
###....###
####DD####
