##########
#E#E#...E#
#.#.#.####
#.#.#.####
#.#.#.....
#.#.#.....
#.#.#....#
#.#......#
#........#
####..####
