####..####
#.....####
#..#######
#...######
#....#####
#..E..####
#......###
#.....E.##
#........#
####..####
