##########
####.T#K.#
####.E#..#
####..##.#
.......E.#
.......E.#
####..####
####..####
####..E.B#
##########
