####..####
#B.E....B#
#B....E.B#
####..####
..#E..E###
..##..####
#.......##
#........#
####..####
##########
