##########
##.....>##
##......##
#........#
#........#
####..####
####..####
##......##
#........#
####..####
