##########
#....E..E#
#TEEE....#
#TEE.E...#
#TEEE..E..
#BEE.E.E..
#BEEE....#
#BEE.E...#
#.......E#
##########
