####..####
#.....####
#.E.....##
####....##
####......
####......
##.E....##
##......##
#####...##
##########
