##########
#B......<#
#........#
####..####
####..####
####..####
####..####
####..####
####..####
####..####
