##########
#E>......#
#..%.....#
#....E%..#
#......%.#
#..%...%.#
#..%.....#
#...%....#
#......%.#
####DD####
