##########
####.T#K.#
####..#..#
####..##.#
.......E.#
.......E.#
####..####
####..####
####....B#
##########
