##########
#...KE...#
#.####...#
#.#....###
..#.#..#..
..#.#EE#..
###.#EE#.#
#BE.####.#
##.......#
##########
