####..####
#........#
#.%...E.%#
#.%.....%#
#..%...%B#
#E.%...%.#
#...%.%.E#
#...%.%..#
#........#
####..####
