####DD####
####..####
#E.#..#E.#
#.E#..#.E#
#...EE....
#.........
#........#
#........#
##########
##########
