####..####
####..####
####BB####
####..####
....EE....
..........
##########
##########
##########
##########
