####DD####
#........#
#.E......#
#........#
....%%....
....B%....
#.E......#
#........#
#........#
##########
