####..####
#...E....#
#.%E.EE.%#
#.%.....%#
#..%...%B#
#E.%...%.#
#...%.%.E#
#...%.%..#
#........#
####..####
