##########
#.......<#
#........#
####..####
####..####
####..####
####..####
####..####
####..####
####..####
