##########
#T.......#
#.EE#B#..#
########.#
.........#
..########
#........#
########.#
####.....#
####..####
