####..####
#........#
#...%E.%.#
#..%..%..#
..%.E%.E.#
....%....#
#..%.....#
#....%%E.#
#...%.%EE#
##########
