####..####
####..####
####BB####
####..####
.E..EE....
........E.
##########
##########
##########
##########
