##########
#...KE...#
#.####...#
#.#....###
..#.#..#..
..#.#..#..
###.#EE#.#
#...####.#
##.......#
##########
