##########
#...KE...#
#.####...#
#.#....###
..#.#..#..
..#.#..#..
###.#EE#.#
#B..####.#
##.......#
##########
